2 2 2 2 2 2 2 2 2 2 2 2 2 2 2 2 2 2 2 2 2 2 2 2
2 0 0 0 0 0 0 0 0 0 2 2 2 0 0 0 0 0 0 0 0 0 2 2
2 0 5 5 0 0 0 0 0 2 2 2 0 0 0 0 0 0 0 0 0 0 0 2
2 0 5 5 0 0 0 0 0 0 0 0 0 0 0 0 0 0 0 0 0 0 0 2
2 0 5 5 0 0 0 0 0 2 2 2 0 0 0 0 0 0 0 0 0 0 0 2
2 0 0 0 0 0 0 0 0 0 2 2 2 0 0 0 0 2 2 4 0 4 2 2
2 2 2 2 0 2 2 2 2 2 2 2 2 2 2 2 2 2 0 0 0 0 0 2
2 2 2 2 0 2 2 2 2 2 2 2 2 2 2 2 2 2 0 6 0 6 0 2
2 2 0 0 0 0 0 0 2 2 0 0 0 0 0 2 2 2 0 0 0 0 0 2
2 0 0 0 0 0 0 0 0 0 0 0 0 0 0 0 0 0 0 0 0 0 0 2
2 0 0 0 0 0 0 0 0 0 0 0 0 0 0 0 2 2 0 6 0 6 0 2
2 2 0 0 0 0 0 0 2 2 0 0 0 0 0 2 2 2 2 4 0 4 2 2
2 2 2 2 0 2 2 2 2 3 3 3 0 3 3 3 3 2 2 4 0 4 2 2
2 2 2 2 0 2 2 2 2 1 0 0 0 0 0 0 1 2 0 0 0 0 0 2
2 2 0 0 0 0 0 2 2 1 0 0 0 0 0 0 1 2 0 0 0 0 0 2
2 0 0 0 0 0 0 0 2 1 0 0 0 0 0 0 1 2 0 0 0 0 0 2
2 0 0 0 0 0 0 0 2 1 1 1 1 1 1 1 1 2 2 0 0 0 2 2
2 0 0 0 0 0 0 0 2 2 2 2 2 2 2 2 2 0 0 7 0 7 0 2
2 5 0 0 0 0 0 5 2 2 0 0 0 2 2 0 2 0 7 0 0 0 7 2
2 0 0 0 0 0 0 0 2 0 0 0 0 0 2 2 0 7 0 7 0 7 0 2
2 0 0 0 0 0 0 0 0 0 0 0 0 0 0 0 0 0 0 0 0 0 7 2
2 0 0 0 0 0 0 0 2 0 0 0 0 0 2 2 0 7 0 7 0 7 0 2
2 2 0 0 0 0 0 2 2 2 0 0 0 2 2 0 2 0 7 0 7 0 2 2
2 2 2 2 2 2 2 2 2 2 2 2 2 2 2 2 2 2 2 2 2 2 2 2